NO ./textures/wall_no.xpm
SO ./textures/wall_no.xpm
WE ./textures/wall_no.xpm
EA ./textures/wall_no.xpm

F 0, 23, 45
C 56, 43, 200



1111111111
1010000001
1010001001
1010N00001
1000000001
1111111111