NO ./textures/wall_no.xpm
SO ./textures/wall_no.xpm
WE ./textures/wall_no.xpm
EA ./textures/wall_no.xpm

F 0, 23, 45
C 56, 43, 200



1111111111111111111111111111111
1000000000000000000000000000001
1000000000000000000000000000001
1000011111111111111111100000001
1000010000000000000000000000001
1000010000000000000000000000001
1000010000000000000000000000001
1000010000000000000000000000001
1000010000000000000000000000001
1000000000000000000000000000001
1000000000000000000N00000000001
1000000000000000000000000000001
1000000000000000000000000000001
1111111111111111111111111111111