NO ./textures/01bricks1.xpm
SO ./textures/blocks1.xpm
WE ./textures/brick_wall.xpm
EA ./textures/Dungeon_wall2.xpm

F 0, 23, 155
C 0, 43, 45



1111111111111111111111111111111
1000000000000000000000000000001
1000000000000000000000000000001
1000000000000011000000000000001
1000000000000000000000000000001
1000000010000000000000000000001
1000000000000000S00000001000001
1000000010000000000000000000001
1000000000000000000000000000001
1000000000000000000000000000001
1000000000000000000000000000001
1000000000000000000000000000001
1111111111111000011111111111111
1000000000000000000000000000001
1000000000100000000000000000001
1000000000000000000000000000001
1000000000000000000000000000101
1000000000000000000001110000001
1000000000000000000000000000001
1000000000000000000000000000001
1000000000000000000000000000001
1000000000000000000000000000001
1000000000000000000000000000001
1000000000000000000000000000001
1000000000000000000000000000001
1000000000000000000000000000001
1000000000000000000000000000001
1000000000000000000000000000001
1000000000000000000000000000001
1000000000000000000000000000001
1000000000000000000000000000001
1000000000000000000000000000001
1111111111111111111111111111111