NO ./anim1.xpm
SO ./anim1.xpm
WE ./anim1.xpm
EA ./anim1.xpm

F 0, 23, 45
C 56, 43, 200



1111111  1
111111111 
 111111111
1111  1111