NO ./anim1.xpm
SO ./anim1.xpm
WE ./anim1.xpm
EA ./anim1.xpm

F 0, 23, 45
C 56, 43, 200



        1111111111111111111111111
        1000000000110000000000001
        1011000001110000000000001
        1001000000000000000000001
111111111011000001110000000000001
100000000011000001110111111111111
11110111111111011100000010001
11110111111111011101010010001
11000000110101011100000010001
10000111000000001100000010001
100001 1000000001101010010001
11000111110101011111011110N0111
11110111 1110101 101111010001
11111111 1111111 111111111111
