NO ./anim1.xpm
SO ./anim1.xpm
WE ./anim1.xpm
EA ./anim1.xpm

F 0, 23, 45
C 56, 43, 200


11111111111111111111
10000000000000000001111111111111
100000000E000000000000000000000011111111
11111111111111111111000000000000000000001               11111
11111111111111111111111111111111111111111               11111
                                                        11111